{
  "levels" :
  [
    {
      "number": 1,
      "time": 0,
      "chip number": 3,
      "optional fields": {
        "map title": "Cheese",
        "map hint": "Art is cheese made visible.",
        "encoded password": [202, 204, 212, 220, 203, 216]
      },
      "upper layer": [0, 0, 0, 0, 0, 0, 0, 0, 0, 0, 0, 0, 0, 0, 0, 0,
                      0, 1, 1, 1, 1, 1, 1, 1, 1, 1, 1, 1, 1, 1, 1, 0,
                      0, 1, 0, 0, 0, 0, 0, 0, 0, 0, 34, 0, 0, 0, 1, 0,
                      0, 1, 0, 0, 0, 1, 24, 1, 1, 0, 1, 1, 0, 0, 1, 0,
                      0, 1, 0, 1, 0, 1, 0, 0, 1, 0, 0, 1, 0, 0, 1, 0,
                      0, 1, 0, 1, 0, 1, 0, 2, 1, 1, 0, 1, 0, 21, 1, 0,
                      0, 1, 0, 1, 0, 1, 1, 1, 0, 0, 0, 0, 1, 1, 1, 0,
                      0, 1, 0, 0, 0, 2, 0, 1, 0, 0, 0, 0, 0, 0, 1, 0,
                      0, 1, 1, 0, 1, 1, 0, 0, 0, 0, 1, 1, 0, 0, 1, 0,
                      0, 1, 0, 0, 0, 0, 0, 1, 1, 0, 1, 0, 0, 0, 1, 0,
                      0, 1, 0, 1, 1, 0, 1, 67, 0, 0, 0, 0, 1, 0, 1, 0,
                      0, 1, 0, 0, 1, 0, 0, 0, 1, 1, 1, 102, 1, 0, 1, 0,
                      0, 1, 1, 0, 0, 0, 1, 0, 1, 1, 0, 0, 0, 0, 1, 0,
                      0, 1, 108, 0, 0, 1, 1, 2, 0, 0, 0, 0, 0, 0, 1, 0,
                      0, 1, 1, 1, 1, 1, 1, 1, 1, 1, 1, 1, 1, 1, 1, 0,
                      0, 0, 0, 0, 0, 0, 0, 0, 0, 0, 0, 0, 0, 0, 0, 0],
      "lower layer": []
    }
  ]
}
